9,10,11,12,13,14,9,10,11,12,13,14,9,10,11,12,
25,26,27,28,29,30,25,26,27,28,29,30,25,26,27,28,
41,42,43,44,45,46,41,42,43,44,45,46,41,42,43,44,
73,74,75,76,77,78,73,74,75,76,77,78,73,74,75,76,
3,0,0,0,0,0,0,0,0,0,0,0,0,0,0,0,
19,20,0,0,0,0,0,0,0,0,0,0,0,0,0,0,
35,36,0,0,0,0,0,0,0,0,0,0,0,0,0,0,
51,52,0,0,0,0,0,0,0,0,0,0,0,0,0,0,
67,68,0,0,0,0,0,0,0,0,0,0,0,0,0,0,
10,11,0,0,0,0,229,230,231,0,0,0,0,0,0,0,
63,27,0,0,0,0,245,246,247,0,0,0,0,0,0,0,
79,43,0,0,0,0,0,0,0,0,0,0,0,0,0,0,